.2.#####.5.
.E.#####.B.
...........
...........
D.F#####A.C
1.3#####4.6
