...#####...
...#####...
...........
...........
DEF#####ABC
123#####456
